L***NKND**
**D*******
***D******
D*D*MM*D*D
D*D*MM*D*D
******D***
*******D**
**DNKN***L
-
0***0000**
**1*******
***2******
3*1*10*0*2
0*2*01*3*1
******0***
*******3**
**2222***2
-
1***1111**
**1*******
***0******
1*0*11*1*0
1*0*00*1*0
******1***
*******0**
**0000***0
-
*0******10
1********0
1********0
1********0
1********0
1********0
1********0
10******1*